border_size=1
usage=map

Xu, Xu, Xu, Xu, Xu, Xu, Xu, Xu, Xu, Xu, Xu, Xu, Xu, Xu, Xu, Qxu, Qxu, Qxu, Qxu, Qxu, Qxu, Qxu, Qxu, Qxu, Qxu, Xu, Xu, Xu, Xu, Xu, Xu, Xu, Xu, Xu, Xu, Xu, Xu
Xu, Xu, Xu, Xu, Xu, Xu, Xu, Xu, Xu, Xu, Xu, Xu, Xu, Xu, Xu, Qxu, Qxu, Qxu, Qxu, Qxu, Qxu, Qxu, Qxu, Qxu, Qxu, Xu, Xu, Xu, Xu, Xu, Xu, Xu, Xu, Xu, Xu, Xu, Xu
Xu, Xu, Xu, Xu, Xu, Xu, Xu, Xu, Xu, Xu, Xu, Xu, Xu, Xu, Xu, Qxu, Qxu, Qxu, Qxu, Qxu, Uu, Qxu, Qxu, Qxu, Uu, Uu^Uf, Uu^Uf, Xu, Uu^Uf, Xu, Xu, Xu, Xu, Xu, Xu, Xu, Xu
Xu, Xu, Xu, Xu, Xu, Xu, Xu, Xu, Xu, Xu, Xu, Uu^Uf, Uu, Uu^Uf, Uu, Uu^Uf, Uu, Uu, Uu, Uu, Uu, Uu, Uu, Uu, Ur, Ur, Ur, Ur, Ur, Uu^Uf, Uu^Uf, Xu, Xu, Xu, Xu, Xu, Xu
Xu, Xu, Xu, Xu, Xu, Xu, Xu, Xu, Uu, Qxu, Uu, Uu, Uu, Uu, Uu, Uu, Xu, Uu, Uu, Uu, Ur, Rb, Ur, Ur, Uu, Ur, Urb, Ur, Ur, Uu, Uu, Uu^Uf, Uu^Uf, Xu, Xu, Xu, Xu
Xu, Xu, Xu, Xu, Xu, Xu, Uu, Uu, Ur, Uu, Uh, Xu, Xu, Xu, Xu, Xu, Xu, Xu, Rb, Rb, Ur, Ur, Xu, Xu, Uu, Urb, Rb, Urb, Uu, Ur, Ur, Uu, Uu^Uf, Xu, Xu, Xu, Xu
Xu, Xu, Xu, Xu, Uu^Uf, Uu, Uu, Uu, Uu, Ur, Ur, Xu, Ur, Uu, Urb, Urb, Urb, Urb, Urb, Urb, Rb^Uf, Uu, Xu, Xu, Uu, Uu, Uu, Uu, Xu, Uu, Ur, Uu, Uu^Uf, Xu, Xu, Xu, Xu
Xu, Xu, Xu, Xu, Uu, Uu, Uu, Uu, Xu, Xu, Uu, Ur, Uu, Urb, Urb, Urb, Urb, Urb, Rb^Uf, Rb^Uf, Rb^Uf, Xu, Xu, Xu, Uu, Uu^Vu, Uu, Uu, Xu, Uu, Ur, Ur, Uu, Xu, Xu, Xu, Xu
Xu, Xu, Xu, Uu^Uf, Ur, Uu, Uh, Xu, Xu, Xu, Uu, Xu, Ur, Ur, Rb, Rb, Rb, Urb, Rb^Uf, Rb^Uf, Rb^Uf, Xu, Xu, Xu, Xu, Uu, Xu, Xu, Xu, Xu, Ur, Uu, Uu, Xu, Xu, Xu, Xu
Xu, Xu, Uu^Uf, Uu, Ur, Uu, Xu, Xu, Xu, Uh, Uu, Uu, Ur, Xu, Rb, Uu, Uu, Rb, Rb, Rb^Uf, Uu, Uu, Xu, Xu, Xu, Xu, Xu, Xu, Xu, Xu, Ur, Ur, Uu, Xu, Xu, Xu, Xu
Xu, Xu, Uu, Ur, Ur, Uu, Xu, Xu, Xu, Uu, Ur, Ur, Uu, Xu, Uu, Xu, Uu^Uf, Uu, Ur, Rb, Rb, Uu, Uu, Uh, Xu, Uh, Uu, Xu, Xu, Xu, Ur, Ur, Uu, Xu, Xu, Xu, Xu
Xu, Xu, Uu, Uu, Ur, Uh, Xu, Xu, Uh, Uu, Ur, Uu, Xu, Xu, Xu, Xu, Xu, Uu, Uu, Ur, Rb, Urb, Uu, Uu, Uu, Uu, Uu, Uu, Xu, Xu, Uu, Ur, Uu, Xu, Xu, Xu, Xu
Xu, Uu^Uf, Uu^Uf, Ur, Ur, Xu, Xu, Xu, Uu, Uu, Ur, Uu, Xu, Xu, Xu, Qxu, Xu, Uu, Uu, Ur, Urb, Urb, Xu, Xu, Xu, Uu, Ur, Uu, Uu, Xu, Uu, Ur, Uu, Xu, Xu, Xu, Xu
Xu, Uu^Uf, Uu^Uf, Ur, Ur, Xu, Xu, Uh, Rb, Rb, Uu, Xu, Xu, Xu, Xu, Uu, Ur, Uu, Uu, Uu, Urb, Urb, Urb, Uu, Uu, Xu, Uu, Ur, Ur, Ur, Ur, Ur, Ur, Uh, Xu, Xu, Xu
Xu, Uu^Uf, Uu, Uu, Urb, Xu, Rb, Rb, Uu, Uu, Xu, Xu, Xu, Xu, Xu, Ur, Uu, Xomy, Xomy, Uu, Rb, Rb, Uu, Uu, Uu, Uu, Xu, Uu, Uu, Uu, Uu, Uu, Ur, Uu, Xu, Xu, Xu
Xu, Xu, Ur, Ur, Xu, Urb, Uu, Uu, Uu, Uu, Xu, Xu, Xu, Xu, Xos, Ur, Ur, Uu, Xomy, Uu, Rb, Uu, Uu, Xos, Xos, Xu, Xu, Xu, Xu, Xu, Xu, Uu, Ur, Uu, Uh, Xu, Xu
Xu, Xu, Ur, Xu, Xu, Uu, Uu, Uu, Xu, Xu, Xu, Xu, Xos, Xos, Xomy, Xomy, Ur, Ur, Cpy, Urb, Rb, Uu, Uu, Xomy, Xomy, Xu, Xu, Xu, Xu, Xu, Ur, Ur, Uu^Uf, Uu^Uf, Uu^Uf, Xu, Xu
Xu, Xu, Ur, Xu, Uu^Uf, Uu, Xu, Rb, Rb, Uh, Uh, Uu, Uu, Uu, Uu, Uu, Brym, Brym, Mybd, Brym, Brym, Uu, Uu^Uf, Uu, Xomy, Xos, Xos, Xu, Uu, Uu, Ur, Uu^Uf, Uu^Uf, Uu^Uf, Uu^Uf, Xu, Xu
Xu, Xu, Ur, Uu, Xu, Uu, Xu, Xu, Xu, Uu, Uu, Xomy, Urb, Uu, Brym, Brym, Mybd, Mybd, Myb, Mybd, Mybd, Brym, Brym, Uu, Uu, Uh, Xos, Uu, Ur, Ur, Ur, Uu^Uf, Ur, Uu^Uf, Uu^Uf, Xu, Xu
Xu, Xu, Uu, Ur, Uu, Uu, Xu, Xu, Xu, Uu, Xomy, Xomy, Urb, Brym, Cmy, Mybd, Myb, Myb, Myb, Myb, Myb, Mybd, Cmy, Uu, Xomy, Uu, Uu^Uf, Ur, Uu, Uu, Xu, Ur, Ur, Uu, Uu, Xu, Xu
Xu, Xu, Uu, Ur, Ur, Uu, Xu, Xu, Xu, Ur, Ur, Rb, Urb, Xomy, Brym, Mybd, Mybd, Myb, Myb, Myb, Mybd, Mybd, Brym, Uu, Xomy, Rb, Uu, Xu, Xu, Xu, Xu, Xu, Ur, Uu, Uu, Xu, Xu
Xu, Xu, Xu, Uu, Urb, Urb, Urb, Xu, Rb, Ur, Uu, Rb, Urb, Xomy, Uu, Brym, Brym, Mybd, Mybd, Mybd, Brym, Brym, Urb, Uu, Uu, Urb, Uu, Xu, Xu, Xu, Xu, Ur, Uu, Uu, Uh, Xu, Xu
Xu, Xu, Xu, Uu, Uu, Urb, Uu, Rb, Xu, Ur, Xos, Xos, Urb, Rb^Uf, Xomy, Xomy, Uu, Brym, Brym, Brym, Uu, Xomy, Urb, Xos, Uu, Urb, Uu, Xu, Xu, Xu, Uu, Ur, Uu, Uu, Xu, Xu, Xu
Xu, Xu, Xu, Xu, Uu, Ur, Uu, Xu, Xu, Ur, Xos, Xos, Urb, Uu, Xos, Uu^Vu, Xos, Xos, Uh, Urb, Uu, Xomy, Xos, Xos, Rb, Urb, Uu, Xu, Xu, Xu, Ur, Ur, Uu, Uh, Xu, Xu, Xu
Xu, Xu, Xu, Uu, Uh, Ur, Ur, Uu, Xu, Uu, Uu, Urb, Urb, Xos, Xos, Uu, Xos, Uu, Uh, Urb, Xu, Uu^Vu, Xu, Xos, Urb, Uh, Uh, Xu, Xu, Uu, Ur, Uu, Uh, Xu, Xu, Xu, Xu
Xu, Xu, Xu, Uu, Uu, Uu, Ur, Uu, Xu, Rb^Uf, Uu, Urb, Urb, Xos, Xu, Uu, Uu, Uu, Urb, Xu, Uu, Uu, Xu, Xu, Ur, Uh, Uu, Xu, Ur, Ur, Uu, Uu, Xu, Xu, Xu, Xu, Xu
Xu, Xu, Xu, Uu, Uu^Uf, Uu, Ur, Xu, Xu, Uu, Uu, Urb, Xu, Uh, Uh, Xu, Urb, Xu, Xu, Xu, Xu, Rb, Xu, Xu, Ur, Ur, Uu, Ur, Ur, Ur, Uu, Uu, Xu, Xu, Xu, Xu, Xu
Xu, Xu, Xu, Uu^Uf, Uu, Uh, Ur, Xu, Xu, Uu, Uu, Urb, Xu, Uh, Uh, Xu, Urb, Xu, Xu, Urb, Urb, Xu, Xu, Xu, Uu, Ur, Ur, Ur, Uu, Uu, Xu, Xu, Xu, Xu, Xu, Xu, Xu
Xu, Xu, Xu, Xu, Uu, Uu, Ur, Xu, Xu, Ur, Uu, 1 Uu, Rb, Xu, Xu, Uu, Urb, Xu, Rb, Uu, Xu, Xu, Xu, Uu, Ur, Ur, Uu, Uu, Uu, Uu, Xu, Xu, Xu, Xu, Xu, Xu, Xu
Xu, Xu, Xu, Xu, Uu, Uu, Uu, Ur, Ur, Rb, Uu, Uh, Uu, Uu, Xu, Uu, Xu, Xu, Xu, Uu, Ur, Ur, Uu, Rb, Rb, Uu, Uh, Xu, Xu, Xu, Xu, Xu, Xu, Xu, Xu, Xu, Xu
Xu, Xu, Xu, Xu, Xu, Uu, Uu, Uu, Uu, Ur, Xu, Xu, Uh, Uu, Urb, Urb, Xu, Uu, Urb, Urb, Uu, Uu, Uu, Uu, Uu, Uu^Uf, Xu, Xu, Xu, Xu, Xu, Xu, Xu, Xu, Xu, Xu, Xu
Xu, Xu, Xu, Xu, Xu, Uu, Uu, Uu, Uu, Ur, Urb, Urb, Uh, Uu, Urb, Rb, Uu, Urb, Urb, Xu, Xu, Uu, Uu, Uu, Uu, Xu, Xu, Xu, Xu, Xu, Xu, Xu, Xu, Xu, Xu, Xu, Xu
Xu, Xu, Xu, Xu, Xu, Xu, Xu, Uu^Uf, Xu, Xu, Uu, Urb, Urb, Xu, Xu, Rb, Uh, Urb, Xu, Rb, Xu, Uu, Uu, Uh, Xu, Xu, Xu, Xu, Xu, Xu, Xu, Xu, Xu, Xu, Xu, Xu, Xu
Xu, Xu, Xu, Xu, Xu, Xu, Xu, Xu, Xu, Xu, Uu, Uu, Uu, Rb, Xu, Rb, Rb, Urb, Rb, Rb, Uu, Uu, Uh, Xu, Xu, Xu, Xu, Xu, Xu, Xu, Xu, Xu, Xu, Xu, Xu, Xu, Xu
Xu, Xu, Xu, Xu, Xu, Xu, Xu, Xu, Xu, Xu, Uh, Uh, Uu, Rb, Ce, Ce, Ce, Ce, Ce, Xu, Uu^Uf, Xu, Xu, Xu, Xu, Xu, Xu, Xu, Xu, Xu, Xu, Xu, Xu, Xu, Xu, Xu, Xu
Xu, Xu, Xu, Xu, Xu, Xu, Xu, Xu, Xu, Xu, Xu, Xu, Xu, Xu, Uu^Uf, Ce, 2 Ke, Ce, Xu, Xu, Xu, Xu, Xu, Xu, Xu, Xu, Xu, Xu, Xu, Xu, Xu, Xu, Xu, Xu, Xu, Xu, Xu
Xu, Xu, Xu, Xu, Xu, Xu, Xu, Xu, Xu, Xu, Xu, Xu, Xu, Xu, Xu, Xu, Uu, Uu, Xu, Xu, Xu, Xu, Xu, Xu, Xu, Xu, Xu, Xu, Xu, Xu, Xu, Xu, Xu, Xu, Xu, Xu, Xu
