border_size=1
usage=map

Qxu, Qxu, Qxu, Qxu, Qxu, Qxu, Qxu, Qxu, Qxu, Qxu, Qxu, Qxu, Qxu, Qxu, Qxu, Qxu, Qxu, Qxu, Qxu, Qxu, Qxu, Qxu, Qxu, Qxu, Qxu, Qxu, Qxu
Qxu, Qxu, Qxu, Qxu, Qxu, Qxu, Qxu, Qxu, Qxu, Qxu, Qxu, Qxu, Qxu, Qxu, Qxu, Qxu, Qxu, Qxu, Qxu, Qxu, Qxu, Qxu, Qxu, Qxu, Qxu, Qxu, Qxu
Qxu, Qxu, Qxu, Qxu, Qxu, Qxu, Qxu, Qxu, Qxu, Qxu, Qxu, Qxu, Qxu, Qxu, Qxu, Qxu, Qxu, Qxu, Qxu, Qxu, Qxu, Qxu, Qxu, Qxu, Qxu, Qxu, Qxu
Qxu, Qxu, Qxu, Qxu, Qxu, Qxu, Qxu, Qxu, Qxu, Qxu, Qxu, Qxu, Qxu, Qxu, Qxu, Qxu, Qxu, Qxu, Qxu, Qxu, Qxu, Qxu, Qxu, Qxu, Qxu, Qxu, Qxu
Qxu, Qxu, Qxu, Qxu, Qxu, Qxu, Qxu, Qxu, Qxu, Qxu, Qxu, Qxu, Qxu, Qxu, Qxu, Qxu, Qxu, Qxu, Qxu, Qxu, Qxu, Qxu, Qxu, Qxu, Qxu, Qxu, Qxu
Qxu, Qxu, Qxu, Qxu, Qxu, Qxu, Qxu, Qxu, Uh, Qxu, Qxu, Qxu, Qxu, Qxu, Qxu, Qxu, Qxu, Qxu, Qxu, Qxu, Qxu, Qxu, Qxu, Qxu, Qxu, Qxu, Qxu
Qxu, Qxu, Qxu, Qxu, Qxu, Qxu, Uh, Uh, Cmy, Cmy, Cmy, Uh, Uh, Qxu, Uu, Qxu, Qxu, Qxu, Qxu, Qxu, Qxu, Qxu, Qxu, Qxu, Qxu, Qxu, Qxu
Qxu, Qxu, Qxu, Qxu, Qxu, Qxu, Uh, Uu, Cmy, 4 Kmy, Cmy, Rrc, Rrc, Uu, Uu, Uu, Cmy, Qxu, Qxu, Qxu, Qxu, Qxu, Qxu, Qxu, Qxu, Qxu, Qxu
Qxu, Qxu, Qxu, Qxu, Qxu, Qxu, Uu, Uu, Rrc, Cmy, Rrc, Ymnv, Rrc, Uu, Uu, Uu, Uu, Qxu, Qxu, Qxu, Qxu, Qxu, Qxu, Qxu, Qxu, Qxu, Qxu
Qxu, Qxu, Qxu, Qxu, Qxu, Uh, Uu, Rr, Rrc, Rrc, Rr, Rrc, Uu, Uu, Uu, Uu, Uu, Qxu, Qxu, Qxu, Qxu, Qxu, Qxu, Qxu, Qxu, Qxu, Qxu
Qxu, Qxu, Qxu, Qxu, Qxu, Uh, Uu, Rr, Rr, Rrc, Uu, Uu, Uu, Uu, Uu, Uu, Uu, Uu, Qxu, Qxu, Qxu, Qxu, Qxu, Qxu, Qxu, Qxu, Xu
Qxu, Qxu, Qxu, Qxu, Qxu, Uh, Uu, Uu, Uu, Rr, Uu, Uu, Uu, Uu, Uu, Uu, Uh, Uu, Uu, Qxu, Qxu, Qxu, Uu, Qxu, Rb, Xu, Xu
Xu, Qxu, Uh, Qxu, Uh, Uh, Uu, Uu, Uu, Rr, Rr, Uu, Uu, Uu, Uu, Uu, Ql, Uh, Uh, Uu, Uh, Uh, Uu, Rb, Uu, Xu, Xu
Xu, Xu, Uu, Uh, Ql, Uu, Uu, Uu, Uu, Uu, Uu, Rr, Uu, Uu, Uu, Uu, Uu, Uh, Uh, Uh, Ql, Uh, Uu, Uu^Vu, Uu, Xu, Xu
Xu, Xu, Uu, Ql, Uu, Uu, Uu, Uu, Uu, Uu, Uu, Rr, Rr, Uu, Uu, Uu, Uu, Ql, Uu, Uh, Uu, Uu, Rb, Rb, Uu, Xu, Xu
Xu, Xu, Uu, Rb, Rb, Uu^Vu, Uu, Uu, Uu, Uu, Uu, Rr, Rr, Uu, Uu, Uu, Uu, Uu, Rb, Uu, Rb, Rb, Xomy, Uu, Xomy, Xomy, Xomy
Xomy, Xomy, Uu, Uu, Uu, Rb, Rb, Uu, Uu, Uu, Rr, Rr, Rr, Rr, Rr, Uu, Rb, Rb, Uu, Rb, Xomy, Xomy, Xomy, Xomy, Xomy, Xomy, Xomy
Xomy, Xomy, Xomy, Uu, Uu, Uu, Uu, Rb, Uu, Rr, Uu, Rr, Rr, Uu, Uu, Rb, Xomy, Xomy, Xomy, Xomy, Xomy, Xomy, Xomy, Xomy, Xomy, Xomy, Xomy
Xomy, Xomy, Xomy, Xomy, Xomy, Xomy, Xomy, Uu, Xomy, Uu, Uu, Rr, Cmy, Rr, Xomy, Xomy, Xomy, Xomy, Rrc, Xomy, Rrc, Rrc, Rrc, Rrc, Xomy, Xomy, Xomy
Xomy, Xomy, Brym, Brym, Brym, Xomy, Xomy, Xomy, Xomy, Xomy, Xomy, Brym, Brym, Brym, Brym, Xomy, Rrc, Rrc, Rrc, Rrc, Rrc, Rrc, Rrc, Rrc, Xomy, Xomy, Xomy
Xomy, Xomy, Brym, Brym^Vymb, Brym, Brym, Xomy, Xomy, Rrc, Xomy, Brym, Brym, Brym, Brym, Brym^Bryl, Brym, Rrc, Xomy, Xomy, Rrc, Xomy, Rrc, Xomy, Xomy, Xomy, Xomy, Xomy
Xomy, Xomy, Rrc, Brym, Rrc, Rrc, Rrc, Rrc, Rrc, Rrc, Xomy, Xomy, Brym, Brym, Brym, Brym, Brym, Rrc, Xomy, Xomy, Xomy, Xomy, Xomy, Xomy, Xomy, Xomy, Xomy
Xomy, Xomy, Rrc, Rrc, Rrc, Rrc, Rrc, Rrc, Rrc, Xomy, Xomy, Brym, Brym, Brym, Xomy, Brym, Xomy, Xomy, Xomy, Xomy, Xomy, Xomy, Xomy, Xomy, Xomy, Xomy, Xomy
Xomy, Xomy, Rrc, Rrc, Rrc, Rrc, Xomy, Xomy, Xomy, Xomy, Brym, Xomy, Brym, Xomy, Brym, Brym, Brym, Brym, Brym, Xomy, Xomy, Xomy, Xomy, Xomy, Xomy, Xomy, Xomy
Xomy, Xomy, Rrc, Rrc, Xomy, Xomy, Brym, Xomy, Brym, Brym, Brym, Brym, Brym, Brym, Brym, Brym, Brym, Brym^Vymb, Brym, Brym, Xomy, Xomy, Brym, Xomy, Xomy, Xomy, Xomy
Xomy, Xomy, Xomy, Xomy, Xomy, Xomy, Brym, Brym, Brym, Brym, Brym, Brym, Brym, Brym, Brym, Brym, Brym, Brym, Brym, Brym, Xomy, Brym, Brym, Brym, Brym, Xomy, Xomy
Xomy, Xomy, Xomy, Xomy, Brym, Xomy, Brym, Brym, Brym^Lyml, Brym, Brym, Brym, Cmy, Cmy, Cmy, Brym, Brym, Brym, Xomy, Xomy, Brym, Brym, Brym, Brym, Brym, Xomy, Xomy
Xomy, Xomy, Xomy, Brym, Brym, Brym, Brym, Xomy, Rrc^Lymp, Brym^Lyml, Brym, Brym, Cmy, 1 Kmy, Cmy, Brym, Brym, Brym, Brym, Xomy, Brym, Brym, Brym, Brym, Brym, Xomy, Xomy
Xomy, Xomy, Xomy, Brym, Brym, Brym, Brym, Xomy, Brym^Lyml, Brym^Lyml, Brym, Brym, Brym, Cmy, Brym, Brym, Brym, Brym, Brym, Brym, Xomy, Xomy, Brym, Brym, Xomy, Xomy, Xomy
Xomy, Xomy, Xomy, Brym, Brym, Brym, Xomy, Xomy, Brym, Brym, Brym^Vymb, Brym, Brym, Brym, Brym, Brym, Brym, Brym, Brym, Xomy, Xomy, Brym, Brym, Brym, Xomy, Xomy, Xomy
Xomy, Xomy, Xomy, Brym, Xomy, Xomy, Brym, Brym, Brym, Brym, Brym, Brym, Brym, Brym, Brym, Brym, Xomy, Brym, Brym, Xomy, Xomy, Brym, Xomy, Xomy, Rr, Xomy, Xomy
Xomy, Xomy, Xomy, Xomy, Brym, Brym, Brym, Brym, Brym, Brym, Xomy, Brym, Brym^Bryl, Brym, Brym^Bryl, Brym, Brym, Xomy, Brym, Brym, Rrc, Xomy, Xomy, Rr, Rr, Rr, Xomy
Xomy, Xomy, Xomy, Xomy, Brym, Brym, Brym^Vymb, Brym, Brym, Xomy, Brym, Brym, Brym, Brym, Brym, Brym, Brym, Brym, Rrc, Rrc, Re^Gye, Xomy, Xomy, Rr, Rr, Rr, Xomy
Xomy, Xomy, Xomy, Xomy, Brym, Brym, Brym, Brym, Brym, Brym, Brym, Brym, Brym, Brym, Brym, Brym, Rrc, Rrc, Re^Gye, Re^Gye, Ds, Rd, Rr, Rr, Xomy, Xomy, Xu
Xomy, Xomy, Xomy, Xomy, Brym, Brym, Brym, Brym, Brym, Brym, Brym, Brym, Xomy, Brym, Xomy, Xomy, Xomy, Re^Gye, Ds, Ds, Ds, Ds, Ds, Rr, Rr, Xomy, Xu
Xomy, Xomy, Xomy, Xomy, Xomy, Brym, Brym, Brym, Xomy, Brym, Xomy, Xomy, Xomy, Xomy, Xomy, Xomy, Rr, Rd, Ds, Ds, Dd, Ds, Ds, Rr, Xomy, Xomy, Xu
Xomy, Xomy, Xomy, Xomy, Xomy, Xomy, Xomy, Xomy, Xomy, Xomy, Xomy, Xomy, Xomy, Xomy, Xomy, Xomy, Rr, Rd, Ds, Ds, Ds, Ds^Dr, Ds, Rr, Xomy, Xu, Xu
Xomy, Xomy, Xomy, Xomy, Xomy, Xomy, Xomy, Xomy, Xomy, Xomy, Xomy, Xomy, Rr, Xomy, Rr, Rr, Dd^Dr, Ds, Dd, Dd, Ds, Ds, Ds, Rr, Xomy, Xu, Xu
Xomy, Xomy, Xomy, Xomy, Xomy, Xomy, Xomy, Xomy, Xomy, Xomy, Rr, Rr, Rd, Rr, Ds, Ds, Dd, Dd, Dd, Dd, Dd, Dd, Ds, Rr, Rr, Xomy, Xu
Xomy, Xomy, Xomy, Xomy, Xomy, Xomy, Xomy, Xomy, Rr, Rr, Rd, Rd, Ds, Ds, Ds, Ds, Dd, Ds, Dd, Dd, Dd, Ds, Ds, Ds, Rr, Xomy, Xu
Xomy, Xomy, Xomy, Xomy, Xomy, Xomy, Xomy, Xomy, Rr, Rr, Rd, Rd, Rd, Ds, Ds, Ds, Ds, Ds, Dd, Dd, Dd, Dd, Ds, Ds, Rr, Xomy, Xu
Xu, Xomy, Xomy, Xomy, Brym, Xomy, Xomy, Xomy, Rrc, Rr, Rrc, Rd, Ds, Ds, Ds, Ds, Ds, Ds^Dr, Dd, Dd, Ds, Ds, Ds, Ds, Rd, Xomy, Xu
Xu, Xu, Xomy, Brym, Brym^Vymb, Brym, Rrc, Rrc^Gyw, Rrc^Gyw, Rrc, Rrc, Rrc, Ds, Ds, Dd, Dd, Dd, Ds, Ds, Ds, Ds, Ds^Dr, Ds, Ds, Rd, Xomy, Xu
Xu, Xu, Xomy, Brym, Brym, Brym, Brym, Rrc, Rrc, Rrc^Gyw, Xomy, Rrc, Rrc, Ds, Ds, Dd, Ds, Ds, Ds, Ds, Ds, Ds, Rd^Vu, Rd, Xomy, Xomy, Xu
Xu, Xu, Xomy, Rrc, Brym, Brym, Rrc, Rrc, Xomy, Xomy, Rr, Rr, Rd, Ds, Ds^Dr, Ds, Ds, Ds, Rr, Rd, Rd, Rd, Rd, Rd, Xomy, Xu, Xu
Xu, Xu, Xomy, Rrc, Brym, Brym, Rrc, Xomy, Xu, Xomy, Xomy, Rr, Rd, Ds, Ds, Ds, Rr, Rr, Xomy, Rr, Xomy, Xomy, Xomy, Xomy, Xu, Xu, Xu
Xu, Xu, Xomy, Rrc, Brym, Brym, Brym, Xomy, Xomy, Xu, Xomy, Rr, Ds, Ds, Rr, Rd, Xomy, Xomy, Xomy, Xomy, Xu, Xu, Xu, Xu, Xu, Xu, Xu
Xu, Xu, Xomy, Rrc, Brym, Brym, Brym, Brym^Vymb, Xomy, Xu, Xomy, Rr, Rr, Rd, Xomy, Xomy, Xu, Xu, Xu, Xu, Xu, Xu, Xu, Xu, Rrc^Vymb, Xu, Xu
Xu, Xu, Xomy, Rrc, Brym, Brym, Brym, Brym, Xomy, Xu, Xomy, Rr, Xomy, Xomy, Xu, Xomy, Xu, Xu, Xu, Xu, Rr, Xu, Rr, Rrc, Rrc, Xu, Xu
Xu, Xu, Xomy, Rrc, Brym, Brym, Rrc, Xomy, Xu, Xu, Xu, Xomy, Xu, Xu, Xu, Xu, Rr, Xu, Rr, Rr, Rr, Rr, Rr, Rr, Rr, Xu, Xu
Xu, Xu, Xomy, Rrc, Brym, Brym, Rrc, Xomy, Xomy, Xu, Xu, Xu, Xu, Xu, Xu, Rr, Rr, Rr, Rrc, Rr, Rrc, Rr, Rr, Rr, Rr, Xu, Xu
Xu, Xu, Xomy, Rrc, Brym, Brym, Cmy, Rrc, Xomy, Xomy, Xomy, Xomy, Xomy, Xu, Xomy, Xu, Rrc^Gyw, Rrc, Rr, Rrc, Rr, Rr, Rr, Rr, Rr, Xu, Xu
Xu, Xu, Xomy, Rrc, Brym, 6 Kmy, Cmy, Brym, Brym, Rrc, Rrc, Rrc, Rrc, Xomy, Brym, Brym, Brym, Xu, Xu, Rr, Xu, Rr, Rr, Rr, Rr, Xu, Xu
Xu, Xomy, Xomy, Rrc, Xomy, Brym, Brym, Cmy, Brym, Brym, Brym, Rrc, Brym, Brym, Brym, Brym, Xomy, Xu, Xu, Xu, Xu, Xu, Rr, Rr, Rr, Xu, Xu
Xu, Xomy, Xomy, Xomy, Rrc, Rrc, Rrc, Brym, Brym, Brym, Brym^Fynt, Brym, Brym, Brym, Brym, Brym, Xomy, Xu, Xu, Xu, Xu, Xu, Rr, Rr, Rr, Xu, Xu
Xu, Xu, Xomy, Xomy, Rrc, Rrc, Rrc, Rrc, Rrc, Brym, Brym, Brym, Brym, Brym, Brym, Xomy, Xu, Xu, Xu, Xu, Xu, Xu, Xu, Xu, Xu, Xu, Xu
Xu, Xu, Xomy, Xomy, Rrc, Rrc, Rrc, Rrc, Xomy, Brym, Brym, Brym, Brym, Brym, Rrc, Xomy, Xu, Xu, Xu, Xu, Xu, Xu, Xu, Xu, Xu, Xu, Xu
Xu, Xu, Xu, Xomy, Xomy, Xomy, Xomy, Xomy, Xu, Xomy, Xomy, Rrc, Rrc, Rrc, Rr, Xomy, Xu, Xu, Uu, Xu, Xu, Xu, Xu, Xu, Xu, Xu, Xu
Xu, Xu, Xu, Xu, Xu, Xu, Xu, Xu, Xu, Xu, Xu, Rr, Rr, Rr, Ur, Uu, Xu, Xu, Ur, Uu, Uu, Uu^Vu, Uu, Xu, Uu, Xu, Xu
Xu, Xu, Xu, Xu, Xu, Xu, Xu, Xu, Xu, Xu, Xu, Uu, Ur, Ur, Ur, Ur, Ur, Ur^Gyw, Xu, Ur, Ur, Uu, Ur, Uu, Uu, Xu, Xu
Xu, Xu, Xu, Xu, Uu, Xu, Uu, Uu^Vu, Uu, Xu, Ur^Gyw, Ur, Xu, Uu, Uu, Ur, Uu, Xu, Xu, Xu, Uu, Ur, Ur, Ur, Uu, Xu, Xu
Xu, Xu, Xu, Xu, Uu, Uu, Ur, Ur, Ur, Ur, Uu, Xu, Xu, Xu, Uu, Ur, Uu, Uu, Xu, Xu, Uu, Ur, Ur, Ur, Uu, Xu, Xu
Xu, Xu, Xu, Xu, Uu, Ur, Ur, Ur, Ur, Ur, Uu, Xu, Xu, Xu, Xu, Ur, Ur, Uu, Xu, Xu, Uu, Uu, Ur, Ur, Uu, Uu, Xu
Xu, Xu, Xu, Xu, Uu, Uu, Uu, Ur, Uu, Ur, Uu, Uu, Xu, Xu, Uu, Uu, 3 Ur, Uu, Uu^Vu, Xu, Xu, Uu, Uu, Ur, Uu, Xu, Xu
Xu, Xu, Xu, Xu, Xu, Xu, Xu, Uu, Xu, Uu, Uu, Xu, Xu, Xu, Uu, Ur, Ur, Ur, Uu, Xu, Xu, Uu, Uu, Uu, Uu, Xu, Xu
Xu, Xu, Xu, Xu, Ms^Xm, Xu, Xu, Xu, Xu, Xu, Xu, Xu, Xu, Xu, Uu, Ur, Ur, Ur, Uu, Uu, Xu, Xu, Xu, Uu, Xu, Xu, Xu
Ms^Xm, Xu, Ms^Xm, Ms^Xm, Ms^Xm, Ms^Xm, Ms^Xm, Ms^Xm, Ms^Xm, Xu, Xu, Xu, Xu, Xu, Uu, Uu, Ur, Uu, Uu, Uu, Xu, Xu, Xu, Xu, Xu, Xu, Ms^Xm
Ms^Xm, Ms^Xm, Ms^Xm, Ms^Xm, Ms^Xm, Ms^Xm, Ms^Xm, Ms^Xm, Ms^Xm, Xu, Xu, Xu, Xu, Xu, Rr, Uu, Rr, Uu, Rr, Uu, Xu, Xu, Xu, Xu, Ms^Xm, Ms^Xm, Ms^Xm
Ms^Xm, Ms^Xm, Ms^Xm, Ms^Xm, Ms^Xm, Ms^Xm, Ms^Xm, Ms^Xm, Ms^Xm, Ms^Xm, Ms^Xm, Xu, Rr, Rr, Rr, Rr, Rr, Rr, Rr, Rr, Rr, Xu, Xu, Ms^Xm, Ms^Xm, Ms^Xm, Ms^Xm
Ms^Xm, Ms^Xm, Ms^Xm, Ms^Xm, Ms^Xm, Ms^Xm, Ms^Xm, Ms^Xm, Ms^Xm, Ms^Xm, Ms^Xm, Ms^Xm, Rr, Rr, 5 Cay, Rr, Rr, Rr, 2 Cay, Rr, Rr, Rr, Rr, Ms^Xm, Ms^Xm, Ms^Xm, Ms^Xm
Ms^Xm, Ms^Xm, Ms^Xm, Ms^Xm, Ms^Xm, Ms^Xm, Ms^Xm, Ms^Xm, Ms^Xm, Ms^Xm, Ms^Xm, Rr, Rr, Rr, Rr, Rr, Rr, Rr, Rr, Rr, Rr, Rr, Ms^Xm, Ms^Xm, Ms^Xm, Ms^Xm, Ms^Xm
Ms^Xm, Ms^Xm, Ms^Xm, Ms^Xm, Ms^Xm, Ms^Xm, Ms^Xm, Ms^Xm, Ms^Xm, Ms^Xm, Ms^Xm, Rr, Rr, Rr, Rr, Rr, Rr, Rr, Rr, Rr, Rr, Rr, Ms^Xm, Ms^Xm, Ms^Xm, Ms^Xm, Ms^Xm
