border_size=1
usage=map

Xos, Xos, Xos, Xos, Xos, Xos, Xos, Xos, Xos, Xos, Xos, Xos, Xos, Xos
Xos, Xos, Xos, Xos, Xos, Xos, Xos, Xos, Xos, Xos, Xos, Xos, Xos, Xos
Xos, Xos, Xos, Xos, Xos, Ce^Bryl, Ce, Ce^Bryl, Xos, Xos, Xos, Xos, Xos, Xos
Xos, Xos, Xos, Xos, Xos, Ce^Xo, Iwr^Taby, Ce^Xo, Xos, Xos, Xos, Xos, Xos, Xos
Xos, Xos, Iwr, Iwr^Xo, Xos, Iwr, Iwr, Iwr, Iwr, Xos, Xos, Xos, Xos, Xos
Xos, Iwr, Iwr^Taby, Iwr^Taby, Iwr, Xos, Re, Iwr, Iwr, Iwr, Iwr, Xos, Xos, Xos
Xos, Xos, Xos, Iwr, Re, Re, Re, Iwr^Taby, Re, Iwr, Re, Iwr^Taby, Xos, Xos
Xos, Xos, Xos, Xos, Re, Re, Re, Re, Re, Re, Iwr, Iwr, Xos, Xos
Xos, Xos, Xos, Re, Re, Re, Ce, Re, Re, Re, Re, Iwr, Xos, Xos
Xos, Xos, Xos, Xos, Iwr, Ce, 1 Ke, Ce, Iwr, Re, Xos, Xos, Xos, Xos
Xos, Xos, Xos, Xos, Re, Ce, Ce, Ce, Re, Xos, Xos, Xos, Xos, Xos
Xos, Xos, Xos, Xos, Re, Re, Rb, Re, Rb, Xos, Xos, Xos, Xos, Xos
Xos, Xos, Xos, Xos, Rb, Rb, Rb, Rb, Aa, Xos, Xos, Xos, Xos, Xos
Xos, Xos, Xos, Xos, Xos, Aa, Aa, Aa, Aa, Xos, Xos, Xos, Xos, Xos
